########################################
#                #                     #
#     *    a  %  D   &              *  #
#                #                     #
#     &          #                     #
#                ###########D###########                
#                      &               #
#     &     *                     *    #
#                            $      %  #
########################################